R 800 600
NO ./textures/NO.xpm
SO ./textures/SO.xpm
WE ./textures/WE.xpm
EA ./textures/EA.xpm
S ./textures/SPR.xpm
C 0, 89, 100
F 255,190,0

             111111111111111
             100000000000001
             100000000000001     
             10000000000001
             100000000000001
1111111111111100000020000111
12000111000000E000000000001                1111111111111111     
100001 111000000111111111111               10000000002000001
100001 1000000001                         10000000000000001
100001 1110100011                         1000000000000001
100001111111100011                         111111111111111
100000000000000111
1000111110000001
11111000011111111